15 15 15 15 15 15 15 15 15 15 15 15 15 15 15 15 15 15 15 15 15 15 15 15 15 15 15 15 15 15 15 15 15 15 15 15 15 15 15 15 15 15 15 15 15 15 15 15 15 15 15 15 15 15 15 15 15 15 15 15 15 15 15 15 15 15 15 15 15 15 15 15 15 15 15 15 15 15 15 15 15 15 15 15 15 15 15 15 15 15 15 15 15 15 15 15 15 15 15 15 15 15 15 15 15 15 15 15 15 15 15 15 15 15 15 15 15 15 15 15 15 15 15 15 15 15 15 
15 0 0 0 0 0 0 0 0 0 0 0 0 0 0 0 0 0 0 0 0 0 0 0 0 0 0 0 0 0 0 0 0 0 0 0 0 0 0 0 0 0 0 0 0 0 0 0 0 0 0 0 0 0 0 0 0 0 0 0 0 0 0 0 0 0 0 0 0 0 0 0 0 0 0 0 0 0 0 0 0 0 0 0 0 0 0 0 0 0 0 0 0 0 0 0 0 0 0 0 0 0 0 0 0 0 0 0 0 0 0 0 0 0 0 0 0 0 0 0 0 0 0 0 15
15 0 0 0 0 0 0 0 0 0 0 0 0 0 0 0 0 0 0 0 0 0 0 0 7 0 0 0 0 0 0 0 0 0 0 0 0 0 0 0 0 0 0 0 0 0 0 0 0 0 0 0 0 0 0 0 0 0 0 0 0 0 0 0 0 0 0 0 0 0 0 0 0 0 0 0 0 0 0 0 0 0 0 0 0 0 0 0 0 0 0 0 0 0 0 0 0 0 0 0 0 0 0 0 0 0 0 0 0 0 0 0 0 0 0 0 0 0 0 0 0 0 0 0 15
15 12 0 0 0 0 0 0 0 0 0 11 2 0 0 0 0 0 8 0 0 0 0 0 1 0 0 0 0 0 0 0 0 11 0 0 0 0 0 0 0 0 0 0 0 0 0 0 2 2 0 0 0 0 0 0 0 0 1 1 1 1 0 0 0 0 0 0 0 0 0 0 0 0 0 0 0 0 0 0 0 0 0 0 0 0 0 0 0 0 0 0 0 0 0 0 0 0 0 0 0 0 0 0 0 0 0 0 0 0 0 0 0 2 2 0 0 0 0 0 0 0 7 0 15
15 1 0 7 0 0 0 0 0 0 0 2 0 0 0 0 2 0 2 0 0 0 0 0 1 1 1 0 0 0 0 0 0 1 0 0 0 0 0 0 0 0 0 0 0 0 0 0 2 12 0 0 0 0 0 0 0 9 9 0 8 1 0 0 0 0 0 0 0 0 0 0 0 0 0 0 0 0 0 0 0 0 0 0 0 0 0 0 0 0 0 0 0 0 0 0 0 0 0 0 0 0 0 0 0 9 11 8 0 0 0 0 0 0 0 0 0 0 0 0 0 0 0 0 15
15 0 0 1 0 0 0 0 0 0 0 0 0 0 0 0 0 0 0 0 0 0 0 0 0 0 0 0 0 0 0 0 0 0 0 0 0 0 0 0 0 0 0 0 0 0 0 0 2 2 2 2 0 0 0 0 0 1 1 1 1 1 0 0 0 0 0 0 0 0 0 0 0 0 0 0 1 0 0 0 0 0 0 0 0 0 0 0 0 0 0 0 0 0 0 0 0 0 0 0 0 0 0 0 0 2 0 0 0 0 0 0 9 0 0 0 0 0 0 2 0 0 0 0 15
15 0 0 0 9 0 7 0 0 0 0 0 0 0 2 0 0 0 0 0 0 0 0 0 0 0 0 0 0 0 0 0 0 0 1 0 1 0 1 0 0 0 0 0 0 0 0 0 0 0 0 0 0 0 0 0 0 0 0 0 0 0 0 0 0 0 0 0 0 0 0 0 8 0 0 0 1 1 0 0 0 0 0 0 0 0 0 0 0 0 0 0 0 0 0 0 0 0 0 0 0 0 0 0 0 0 0 0 0 0 0 0 1 0 0 0 1 0 0 0 0 0 0 0 15
15 0 0 0 1 1 1 0 0 0 0 0 0 0 0 0 0 0 0 0 0 0 0 0 0 0 0 0 2 2 0 0 0 1 0 0 0 0 0 0 0 0 0 0 0 0 0 0 0 0 0 0 0 0 0 2 2 0 0 0 0 0 0 0 0 0 0 0 0 0 0 0 0 0 0 0 1 0 1 0 0 0 0 0 0 0 0 0 0 0 0 0 0 0 0 0 0 0 0 0 0 0 0 0 0 7 0 0 0 0 0 0 0 0 0 0 0 0 0 0 0 0 0 0 15
15 0 0 0 0 0 0 0 0 0 0 0 0 0 0 0 0 0 0 0 0 0 0 0 0 0 2 2 2 2 0 0 0 0 0 0 0 0 0 0 0 0 0 0 0 0 0 0 0 0 0 0 0 0 0 2 2 0 0 0 0 0 0 0 0 0 0 0 0 0 0 0 0 0 0 9 1 0 0 1 0 0 0 0 0 0 0 0 0 0 0 2 0 0 0 0 0 0 0 0 0 0 0 0 0 0 0 0 2 0 0 0 12 0 0 0 0 0 0 0 0 0 0 0 15
15 0 0 0 0 0 0 0 0 0 0 0 0 0 0 0 0 0 0 0 0 0 0 0 0 2 2 8 2 2 0 0 0 0 0 0 0 0 0 0 0 0 0 0 0 0 0 0 0 0 0 0 0 2 2 2 2 0 0 0 0 0 0 0 0 0 0 0 0 0 0 0 0 0 0 1 0 0 0 0 0 0 0 0 0 0 0 0 0 0 0 2 0 0 0 0 0 1 0 0 0 0 0 0 0 0 0 0 0 0 2 0 0 0 0 0 0 0 0 0 0 2 0 0 15
15 0 0 0 0 0 0 0 2 2 0 0 1 0 0 0 1 1 0 0 0 0 0 0 2 2 2 7 2 2 2 0 0 0 0 0 0 0 0 0 0 0 0 0 0 0 0 0 0 0 0 0 0 2 2 2 2 0 0 0 0 0 0 0 0 0 0 0 0 0 0 0 0 0 0 1 0 0 0 0 0 1 0 0 0 0 0 0 0 2 0 2 0 0 1 0 0 0 0 0 0 0 0 0 0 0 0 0 0 0 0 0 0 0 0 0 0 0 1 0 0 0 0 0 15
15 0 0 0 0 0 2 2 2 2 0 0 0 0 0 1 1 0 0 0 0 0 0 2 2 2 2 0 2 2 2 0 0 0 0 0 0 0 0 14 0 0 0 0 0 1 0 0 0 0 0 2 2 2 2 2 0 0 0 0 0 0 1 1 1 1 1 1 0 0 0 1 0 0 1 0 0 0 0 0 0 0 1 0 0 0 0 0 0 0 0 2 0 9 1 0 0 9 0 0 0 0 0 0 0 0 0 0 0 0 0 0 0 0 0 0 1 0 0 0 0 0 0 0 15
15 0 0 0 0 2 2 2 2 2 6 6 6 6 6 1 1 7 9 0 0 0 2 2 2 2 2 9 9 9 9 9 0 0 0 0 12 8 8 17 3 3 3 18 0 0 0 0 0 0 0 2 2 2 2 2 0 0 0 0 0 0 1 1 1 1 1 1 7 0 9 0 9 1 8 0 0 0 0 0 0 0 0 7 0 0 0 1 9 0 0 8 1 1 1 0 0 2 0 0 0 0 1 0 1 1 0 0 0 0 0 0 0 0 9 0 0 0 0 0 9 9 0 16 15 
15 2 2 2 2 2 2 2 2 2 5 5 5 5 5 1 1 1 1 6 6 2 2 2 2 2 2 2 2 2 2 2 2 6 6 6 17 3 3 4 4 4 4 4 6 6 6 6 6 2 0 9 9 8 9 9 0 2 6 6 6 6 1 1 1 1 1 1 1 1 1 1 1 1 1 1 5 6 0 0 0 5 6 1 0 0 1 1 1 1 1 1 1 1 1 1 0 2 2 2 0 0 1 0 0 0 0 0 1 0 0 1 1 1 1 1 0 0 0 0 5 6 5 6 15 
15 2 2 2 2 2 2 2 2 2 5 5 5 5 5 1 1 1 1 5 5 2 2 2 2 2 2 2 2 2 2 2 2 5 5 5 4 4 4 4 4 4 4 4 5 5 5 5 5 2 2 2 2 2 2 2 2 2 5 5 5 5 1 1 1 1 1 1 1 1 1 1 1 1 1 1 4 4 0 0 0 4 4 1 0 0 1 1 1 1 1 1 1 1 1 0 0 4 4 4 0 0 1 0 0 0 0 0 0 0 0 1 1 1 1 1 9 0 0 9 4 4 4 4 15
15 2 2 2 2 2 2 2 2 2 5 5 5 5 5 1 1 1 1 5 5 2 2 2 2 2 2 2 2 2 2 2 2 5 5 5 4 4 4 4 4 4 4 4 5 5 5 5 5 2 2 2 2 2 2 2 2 2 5 5 5 5 1 1 1 1 1 1 1 1 1 1 1 1 1 1 4 4 4 0 0 4 4 1 0 0 1 1 1 1 1 1 1 1 1 0 0 4 4 4 0 0 4 0 0 0 0 0 0 0 0 1 1 1 1 1 4 4 0 4 4 4 4 4 15
15 2 2 2 2 2 2 2 2 2 5 5 5 5 5 1 1 1 1 5 5 2 2 2 2 2 2 2 2 2 2 2 2 5 5 5 4 4 4 4 4 4 4 4 5 5 5 5 5 2 2 2 2 2 2 2 2 2 5 5 5 5 1 1 1 1 1 1 1 1 1 1 1 1 1 1 4 4 4 0 0 4 4 1 0 0 1 1 1 1 1 1 1 1 1 0 0 4 4 4 0 0 4 0 0 0 0 0 0 0 0 1 1 1 1 1 4 4 0 4 4 4 4 4 15
