15 15 15 15 15 15 15 15 15 15 15 15 15 15 15 15 15 15 15 15 15 15 15 15 15 15 15 15 15 15 15 15 15 15 15 15 15 15 15 15 15 15 15 15 15 15 15 15 15 15 15 15 15 15 15 15 15 15 15 15 15 15 15 15 15 15 15 15 15 15 15 15 15 15 15 15 15 15 15 15 15 15 15 15 15 15 15 15 15 15 15 15 15 15 15 15 15 15 15 15 15 15 15 15 15 15 15 15 15 15 15 15 15 15 15 15 15 15 15 15 15 15 15 15 15 15 15 
15 0 0 0 0 0 0 0 0 0 0 0 0 0 0 0 0 0 0 0 0 0 0 0 0 0 0 0 0 0 0 0 0 0 0 0 0 0 0 0 0 0 0 0 0 0 0 0 0 0 0 0 0 0 0 0 0 0 0 0 0 0 0 0 0 0 0 0 0 0 0 0 0 0 0 0 0 0 0 0 0 0 0 0 0 0 0 0 0 0 0 0 0 0 0 0 0 0 0 0 0 0 0 0 0 0 0 0 0 0 0 0 0 0 0 0 0 0 0 0 0 0 0 0 15
15 0 0 0 0 0 0 0 0 0 0 0 0 0 0 0 0 0 0 0 0 0 0 0 7 0 0 0 0 0 0 0 0 0 0 0 0 0 0 0 0 0 0 0 0 0 0 0 0 0 0 0 0 0 0 0 0 0 0 0 0 0 0 0 0 0 0 0 0 0 0 0 0 0 0 0 0 0 0 0 0 0 0 0 0 0 0 0 0 0 0 0 0 0 0 0 0 0 0 0 0 0 0 0 0 0 0 0 0 0 0 0 0 0 0 0 0 0 0 0 0 0 0 0 15
15 12 0 0 0 0 0 0 0 0 0 11 2 0 0 0 0 0 8 0 0 0 0 0 1 0 0 0 0 0 0 0 0 11 0 0 0 0 0 0 0 0 0 0 0 0 0 0 2 2 0 0 0 0 0 0 0 0 1 1 1 1 0 0 0 0 0 0 0 0 0 0 0 0 0 0 0 0 0 0 0 0 0 0 0 0 0 0 0 0 0 0 0 0 0 0 0 0 0 0 0 0 0 0 0 0 0 0 0 0 0 0 0 2 2 0 0 0 0 0 0 0 7 0 15
15 1 0 7 0 0 0 0 0 0 0 2 0 0 0 0 2 0 2 0 0 0 0 0 1 1 1 0 0 0 0 0 0 1 0 0 0 0 0 0 0 0 0 0 0 0 0 0 2 12 0 0 0 0 0 0 0 9 9 0 8 1 0 0 0 0 0 0 0 0 0 0 0 0 0 0 0 0 0 0 0 0 0 0 0 0 0 0 0 0 0 0 0 0 0 0 0 0 0 0 0 0 0 0 0 9 11 8 0 0 0 0 0 0 0 0 0 0 0 0 0 0 0 0 15
15 0 0 1 0 0 0 0 0 0 0 0 0 0 0 0 0 0 0 0 0 0 0 0 0 0 0 0 0 0 0 0 0 0 0 0 0 0 0 0 0 0 0 0 0 0 0 0 2 2 2 2 0 0 0 0 0 1 1 1 1 1 0 0 0 0 0 0 0 0 0 0 0 0 0 0 1 0 0 0 0 0 0 0 0 0 0 0 0 0 0 0 0 0 0 0 0 0 0 0 0 0 0 0 0 2 0 0 0 0 0 0 9 0 0 0 0 0 0 2 0 0 0 0 15
15 0 0 0 9 0 7 0 0 0 0 0 0 0 2 0 0 0 0 0 0 0 0 0 0 0 0 0 0 0 0 0 0 0 1 0 1 0 1 0 0 0 0 0 0 0 0 0 0 0 0 0 0 0 0 0 0 0 0 0 0 0 0 0 0 0 0 0 0 0 0 0 8 0 0 0 1 1 0 0 0 0 0 0 0 0 0 0 0 0 0 0 0 0 0 0 0 0 0 0 0 0 0 0 0 0 0 0 0 0 0 0 1 0 0 0 1 0 0 0 0 0 0 0 15
15 0 0 0 1 1 1 0 0 0 0 0 0 0 0 0 0 0 0 0 0 0 0 0 0 0 0 0 2 2 0 0 0 1 0 0 0 0 0 0 0 0 0 0 0 0 0 0 0 0 0 0 0 0 0 2 2 0 0 0 0 0 0 0 0 0 0 0 0 0 0 0 0 0 0 0 1 0 1 0 0 0 0 0 0 0 0 0 0 0 0 0 0 0 0 0 0 0 0 0 0 0 0 0 0 7 0 0 0 0 0 0 0 0 0 0 0 0 0 0 0 0 0 0 15
15 0 0 0 0 0 0 0 0 0 0 0 0 0 0 0 0 0 0 0 0 0 0 0 0 0 2 2 2 2 0 0 0 0 0 0 0 0 0 0 0 0 0 0 0 0 0 0 0 0 0 0 0 0 0 2 2 0 0 0 0 0 0 0 0 0 0 0 0 0 0 0 0 0 0 9 1 0 0 1 0 0 0 0 0 0 0 0 0 0 0 2 0 0 0 0 0 0 0 0 0 0 0 0 0 0 0 0 2 0 0 0 12 0 0 0 0 0 0 0 0 0 0 0 15
15 0 0 0 0 0 0 0 0 0 0 0 0 0 0 0 0 0 0 0 0 0 0 0 0 2 2 8 2 2 0 0 0 0 0 0 0 0 0 0 0 0 0 0 0 0 0 0 0 0 0 0 0 2 2 2 2 0 0 0 0 0 0 0 0 0 0 0 0 0 0 0 0 0 0 1 0 0 0 0 0 0 0 0 0 0 0 0 0 0 0 2 0 0 0 0 0 1 0 0 0 0 0 0 0 0 0 0 0 0 2 0 0 0 0 0 0 0 0 0 0 2 0 0 15
15 0 0 0 0 0 0 0 2 2 0 0 1 0 0 0 1 1 0 0 0 0 0 0 2 2 2 7 2 2 2 0 0 0 0 0 0 0 0 0 0 0 0 0 0 0 0 0 0 0 0 0 0 2 2 2 2 0 0 0 0 0 0 0 0 0 0 0 0 0 0 0 0 0 0 1 0 0 0 0 0 1 0 0 0 0 0 0 0 2 0 2 0 0 1 0 0 0 0 0 0 0 0 0 0 0 0 0 0 0 0 0 0 0 0 0 0 0 1 0 0 0 0 0 15
15 0 0 0 0 0 2 2 2 2 0 0 0 0 0 1 1 0 0 0 0 0 0 2 2 2 2 0 2 2 2 0 0 0 0 0 0 0 0 14 0 0 0 0 0 1 0 0 0 0 0 2 2 2 2 2 0 0 0 0 0 0 1 1 1 1 1 1 0 0 0 1 0 0 1 0 0 0 0 0 0 0 1 0 0 0 0 0 0 0 0 2 0 0 1 0 0 9 0 0 0 0 0 0 0 0 0 0 0 0 0 0 0 0 0 0 1 0 0 0 0 0 0 0 15
15 0 0 0 0 2 2 2 2 2 18 18 18 18 18 1 1 7 9 0 0 0 2 2 2 2 2 0 0 0 0 0 2 0 0 0 12 8 8 5 3 3 3 6 0 0 0 0 0 0 0 2 2 2 2 2 0 0 0 0 0 0 1 1 1 1 1 1 7 0 0 0 0 1 8 0 0 0 0 0 0 0 0 7 0 0 0 1 0 0 0 8 1 1 1 0 0 2 0 0 0 0 1 0 1 1 0 0 0 0 0 0 0 0 9 0 0 0 0 0 9 9 0 16 15 
15 2 2 2 2 2 2 2 2 2 17 17 17 17 17 1 1 1 1 18 18 2 2 2 2 2 2 2 2 2 2 2 2 18 18 18 5 3 3 4 4 4 4 4 18 18 18 18 18 2 0 0 0 8 0 0 0 2 18 18 18 18 1 1 1 1 1 1 1 1 1 1 1 1 1 1 5 6 0 0 0 5 6 1 0 0 1 1 1 1 1 1 1 1 1 1 0 2 2 2 0 0 1 0 0 0 0 0 1 0 0 1 1 1 1 1 0 0 0 0 5 6 5 6 15 
15 2 2 2 2 2 2 2 2 2 17 17 17 17 17 1 1 1 1 17 17 2 2 2 2 2 2 2 2 2 2 2 2 17 17 17 4 4 4 4 4 4 4 4 17 17 17 17 17 2 2 2 2 2 2 2 2 2 17 17 17 17 1 1 1 1 1 1 1 1 1 1 1 1 1 1 4 4 0 0 0 4 4 1 0 0 1 1 1 1 1 1 1 1 1 0 0 4 4 4 0 0 1 0 0 0 0 0 0 0 0 1 1 1 1 1 9 0 0 9 4 4 4 4 15
15 2 2 2 2 2 2 2 2 2 17 17 17 17 17 1 1 1 1 17 17 2 2 2 2 2 2 2 2 2 2 2 2 17 17 17 4 4 4 4 4 4 4 4 17 17 17 17 17 2 2 2 2 2 2 2 2 2 17 17 17 17 1 1 1 1 1 1 1 1 1 1 1 1 1 1 4 4 4 0 0 4 4 1 0 0 1 1 1 1 1 1 1 1 1 0 0 4 4 4 0 0 4 0 0 0 0 0 0 0 0 1 1 1 1 1 4 4 0 4 4 4 4 4 15
15 2 2 2 2 2 2 2 2 2 17 17 17 17 17 1 1 1 1 17 17 2 2 2 2 2 2 2 2 2 2 2 2 17 17 17 4 4 4 4 4 4 4 4 17 17 17 17 17 2 2 2 2 2 2 2 2 2 17 17 17 17 1 1 1 1 1 1 1 1 1 1 1 1 1 1 4 4 4 0 0 4 4 1 0 0 1 1 1 1 1 1 1 1 1 0 0 4 4 4 0 0 4 0 0 0 0 0 0 0 0 1 1 1 1 1 4 4 0 4 4 4 4 4 15

