0 0 0 0 0 0 0 0 0 0 0 0 0 0 0 0
0 0 0 0 0 0 0 0 0 0 0 0 0 0 0 1
0 0 0 0 0 0 0 0 0 0 0 0 0 0 0 2
0 0 0 0 0 0 0 0 0 0 0 0 0 0 0 3
0 0 0 0 0 0 0 0 0 0 0 0 0 0 0 4
0 0 0 0 0 0 0 0 0 0 0 0 0 0 0 0
0 0 0 0 0 0 0 0 0 0 0 0 0 0 0 0
1 0 0 0 0 0 0 0 0 0 0 0 0 0 16 0
0 7 11 9 12 9 0 0 0 0 0 0 0 0 0 0
1 1 1 1 1 1 1 1 0 1 1 3 3 3 3 3
1 1 1 1 1 1 1 1 0 1 4 4 4 4 4 4
1 1 1 1 1 1 1 1 0 1 4 4 4 4 4 4